5 6
1 1 0 0 1 1 
0 1 0 0 1 1 
0 1 0 0 2 1 
0 3 1 1 1 1 
1 2 3 4 5 1 
2
0 1 hello
2 3 bye
